##############E###########
#..............###########
#.######################S#
#.######################.#
#.######################.#
#.######################.#
#.######################.#
#........................#
##########################